25
20
592, 594, 590, 592, 594, 590, 592, 594, 590, 592, 594, 590, 592, 594, 590, 592, 594, 590, 592, 594, 590, 592, 594, 590, 592
590, 592, 594, 590, 592, 594, 590, 592, 594, 590, 592, 594, 590, 592, 594, 590, 592, 594, 590, 592, 594, 590, 592, 594, 590
258, 259, 260, 258, 259, 260, 258, 259, 260, 258, 259, 260, 258, 259, 260, 258, 259, 260, 258, 259, 260, 258, 259, 260, 258
260, 258, 259, 260, 258, 259, 260, 258, 259, 260, 258, 259, 260, 258, 259, 260, 258, 259, 260, 258, 259, 260, 258, 259, 260
259, 260, 258, 259, 260, 258, 259, 260, 258, 259, 260, 258, 261, 260, 258, 259, 260, 258, 259, 260, 258, 259, 260, 258, 259
258, 259, 260, 263, 259, 260, 258, 259, 260, 258, 259, 260, 258, 259, 260, 258, 259, 260, 258, 259, 260, 258, 259, 260, 258
260, 258, 259, 260, 258, 259, 260, 258, 259, 260, 258, 259, 260, 258, 259, 260, 258, 259, 260, 258, 263, 260, 258, 259, 260
259, 260, 258, 259, 260, 258, 259, 260, 263, 259, 260, 258, 259, 260, 258, 259, 260, 258, 259, 260, 258, 259, 260, 258, 259
258, 263, 260, 258, 259, 260, 258, 259, 260, 258, 259, 260, 258, 263, 260, 258, 259, 260, 258, 259, 260, 258, 259, 260, 258
260, 258, 259, 260, 258, 259, 260, 258, 259, 260, 258, 259, 260, 258, 259, 260, 258, 259, 260, 258, 259, 260, 258, 259, 260
259, 260, 258, 259, 260, 262, 259, 260, 258, 259, 260, 258, 259, 260, 258, 259, 260, 258, 259, 260, 258, 261, 260, 258, 259
258, 259, 260, 258, 259, 260, 258, 259, 260, 258, 259, 260, 263, 258, 259, 260, 258, 259, 260, 258, 259, 260, 258, 259, 260
260, 261, 262, 259, 258, 259, 260, 260, 260, 258, 259, 263, 260, 261, 262, 259, 258, 259, 260, 260, 260, 258, 259, 260, 260
1441, 1444, 1441, 1444, 1441, 1444, 1441, 1444, 1441, 1444, 1441, 1444, 1441, 1444, 1441, 1444, 1441, 1444, 1441, 1444, 1441, 1444, 1441, 1444, 1441
1441, 1444, 1441, 1444, 1441, 1444, 1441, 1444, 1441, 1444, 1441, 1444, 1441, 1444, 1441, 1444, 1441, 1444, 1441, 1444, 1441, 1444, 1441, 1444, 1441
1441, 1444, 1441, 1444, 1441, 1444, 1441, 1444, 1441, 1444, 1441, 1444, 1441, 1444, 1441, 1444, 1441, 1444, 1441, 1444, 1441, 1444, 1441, 1444, 1441
1458, 1459, 1458, 1459, 1458, 1459, 1458, 1459, 1458, 1459, 1458, 1459, 1458, 1459, 1458, 1459, 1458, 1459, 1458, 1459, 1458, 1459, 1458, 1459, 1458
1443, 1442, 1443, 1442, 1443, 1442, 1443, 1442, 1443, 1442, 1443, 1442, 1443, 1442, 1443, 1442, 1443, 1442, 1443, 1442, 1443, 1442, 1443, 1442, 1443
1443, 1442, 1443, 1442, 1443, 1442, 1443, 1442, 1443, 1442, 1443, 1442, 1443, 1442, 1443, 1442, 1443, 1442, 1443, 1442, 1443, 1442, 1443, 1442, 1443
1443, 1442, 1443, 1442, 1443, 1442, 1443, 1442, 1443, 1442, 1443, 1442, 1443, 1442, 1443, 1442, 1443, 1442, 1443, 1442, 1443, 1442, 1443, 1442, 1443