25
20
0,0,0,0,0,0,0,0,0,0,1097,106,108,0,1087,0,21,0,0,0,0,0,0,0,0
0,0,0,0,0,0,0,0,0,0,1097,0,0,0,1087,0,0,0,0,0,0,0,0,0,0
0,0,0,0,0,0,0,0,0,0,1097,0,0,0,1087,0,0,0,0,0,0,0,0,0,0
0,0,0,0,0,0,0,0,0,0,1203,1204,1205,1206,1207,0,0,0,0,0,0,0,0,0,0
0,0,0,0,0,0,0,0,0,0,1206,1207,1208,1203,1204,0,0,0,0,0,0,0,0,0,0
0,0,0,0,0,0,0,0,0,0,1203,1204,1205,1206,1207,0,0,0,0,0,0,0,0,0,0
0,0,0,0,0,0,0,0,0,0,1097,0,0,0,1087,0,0,0,0,0,0,0,0,0,0
0,0,0,1087,1203,1204,1205,1206,1207,1208,1097,0,0,0,1087,1206,1207,1208,1203,1204,1205,1097,0,0,0
0,0,0,1087,1206,1207,1208,1203,1204,1205,1097,0,0,0,1087,1203,1204,1205,1206,1207,1208,1097,0,0,0
0,0,0,1087,1203,1204,1205,1206,1207,1208,1097,0,0,0,1087,1206,1207,1208,1203,1204,1205,1097,0,0,0
0,0,0,1087,1206,1207,1208,1203,1204,1205,1097,0,0,0,1087,1203,1204,1205,1206,1207,1208,1097,0,0,0
0,0,0,1087,1203,1204,1205,1206,1207,1208,1097,0,0,0,1087,1206,1207,1208,1203,1204,1205,1097,0,0,0
0,0,0,1087,1206,1207,1208,1203,1204,1205,1097,0,0,0,1087,1203,1204,1205,1206,1207,1208,1097,0,0,0
0,0,0,0,0,0,0,0,0,0,1097,0,0,0,1087,0,0,0,0,0,0,0,0,0,0
0,0,0,0,0,0,0,0,0,0,1097,0,0,0,1087,0,0,0,0,0,0,0,0,0,0
0,0,0,0,0,0,0,0,0,0,1097,0,0,0,1087,0,0,0,0,0,0,0,0,0,0
0,0,0,0,0,0,0,0,0,0,1097,0,0,0,1087,0,0,0,0,0,0,0,0,0,0
0,0,0,0,0,0,0,0,0,0,1097,0,0,0,1087,0,0,0,0,0,0,0,0,0,0
0,0,0,0,0,0,0,0,0,0,1097,0,0,0,1087,0,0,0,0,0,0,0,0,0,0
0,0,0,0,0,0,0,0,0,0,1097,0,0,0,1087,0,0,0,0,0,0,0,0,0,0