25
20
473,475,469,471,473,475,469,471,473,475,469,471,473,475,469,471,473,475,469,471,473,475,469,471,473
475,469,471,473,475,469,471,473,475,469,471,473,475,469,471,473,475,469,471,473,475,469,471,473,475
469,471,473,475,469,471,473,475,469,471,473,475,469,471,473,475,469,471,473,475,469,471,473,475,469
471,473,475,469,471,473,475,469,471,473,475,469,471,473,475,469,471,473,475,469,471,473,475,469,471
473,475,469,471,473,475,469,471,473,475,469,471,473,475,469,471,473,475,469,471,473,475,469,471,473
475,469,471,473,475,469,471,473,475,469,471,473,475,469,471,473,475,469,471,473,475,469,471,473,475
469,471,473,475,469,471,473,475,469,471,473,475,469,471,473,475,469,471,473,475,469,471,473,475,469
471,473,475,469,471,473,475,469,471,473,475,469,471,473,475,469,471,473,475,469,471,473,475,469,471
473,475,469,471,473,475,469,471,473,475,469,471,473,475,469,471,473,475,469,471,473,475,469,471,473
475,469,471,473,475,469,471,473,475,469,471,473,475,469,471,473,475,469,471,473,475,469,471,473,475
469,471,473,475,469,471,473,475,469,471,473,475,469,471,473,475,469,471,473,475,469,471,473,475,469
471,473,475,469,471,473,475,469,471,473,475,469,471,473,475,469,471,473,475,469,471,473,475,469,471
473,475,469,471,473,475,469,471,473,475,469,471,473,475,469,471,473,475,469,471,473,475,469,471,473
475,469,471,473,475,469,471,473,475,469,471,473,475,469,471,473,475,469,471,473,475,469,471,473,475
469,471,473,475,469,471,473,475,469,471,473,475,469,471,473,475,469,471,473,475,469,471,473,475,469
471,473,475,469,471,473,475,469,471,473,475,469,471,473,475,469,471,473,475,469,471,473,475,469,471
473,475,469,471,473,475,469,471,473,475,469,471,473,475,469,471,473,475,469,471,473,475,469,471,473
475,469,471,473,475,469,471,473,475,469,471,473,475,469,471,473,475,469,471,473,475,469,471,473,475
469,471,473,475,469,471,473,475,469,471,473,475,469,471,473,475,469,471,473,475,469,471,473,475,469
471,473,475,469,471,473,475,469,471,473,475,469,471,473,475,469,471,473,475,469,471,473,475,469,471
