25
20
265,267,269,265,267,269,265,267,269,265,267,269,265,267,269,265,267,269,265,267,269,265,267,269,265
267,269,265,267,269,265,267,269,265,267,269,265,267,269,265,267,269,265,267,269,265,267,269,265,267
269,265,267,269,265,267,269,265,267,269,265,267,269,265,267,269,265,267,269,265,267,269,265,267,269
265,267,269,265,267,269,265,267,269,265,267,269,265,267,269,265,267,269,265,267,269,265,267,269,265
267,269,265,267,269,265,267,269,265,267,269,265,267,269,265,267,269,265,267,269,265,267,269,265,267
269,265,267,269,265,267,269,265,267,269,265,267,269,265,267,269,265,267,269,265,267,269,265,267,269
265,267,269,265,267,269,265,267,269,265,267,269,265,267,269,265,267,269,265,267,269,265,267,269,265
267,269,265,267,269,265,267,269,265,267,269,265,267,269,265,267,269,265,267,269,265,267,269,265,267
269,265,267,269,265,267,269,265,267,269,265,267,269,265,267,269,265,267,269,265,267,269,265,267,269
265,267,269,265,267,269,265,267,269,265,267,269,265,267,269,265,267,269,265,267,269,265,267,269,265
-269,-265,-267,-269,-265,-267,-269,-265,-267,-269,-265,-267,-269,-265,-267,-269,-265,-267,-269,-265,-267,-269,-265,-267,-269
-265,-267,-269,-265,-267,-269,-265,-267,-269,-265,-267,-269,-265,-267,-269,-265,-267,-269,-265,-267,-269,-265,-267,-269,-265
-267,-269,-265,-267,-269,-265,-267,-269,-265,-267,269,18,18,-269,-265,-267,-269,-265,-267,-269,-265,-267,-269,-265,-267
212,214,212,214,212,214,212,214,212,214,212,214,212,214,212,214,212,214,212,214,212,214,212,214,212
212,214,212,214,212,214,212,214,212,214,212,214,212,214,212,214,212,214,212,214,212,214,212,214,212
212,214,212,214,212,214,212,214,212,214,212,214,212,214,212,214,212,214,212,214,212,214,212,214,212
212,214,212,214,212,214,212,214,212,214,212,214,212,214,212,214,212,214,212,214,212,214,212,214,212
212,214,212,214,212,214,212,214,212,214,212,214,212,214,212,214,212,214,212,214,212,214,212,214,212
212,214,212,214,212,214,212,214,212,214,212,214,212,214,212,214,212,214,212,214,212,214,212,214,212
212,214,212,214,212,214,212,214,212,214,212,214,212,214,212,214,212,214,212,214,212,214,212,214,212