25
20
80,0,0,0,0,0,0,0,0,0,0,0,0,0,0,0,0,0,0,0,0,0,0,0,0,0,0,0,82
80,0,0,0,0,0,0,0,0,0,0,0,0,0,0,0,0,0,0,0,0,0,0,0,0,0,0,0,82
80,0,0,0,0,0,0,0,0,0,0,0,0,0,0,0,0,0,0,0,0,0,0,0,0,0,0,0,82
80,0,0,0,0,0,0,0,0,0,0,0,0,0,0,0,0,0,0,0,0,0,0,0,0,0,0,0,82
88,89,89,89,89,89,89,89,89,89,89,89,89,89,89,89,89,89,89,89,89,89,89,89,90
-96,-97,-96,-97,-96,-97,-96,-97,-96,-97,-96,97,96,97,-96,-97,-96,-97,-96,-97,-96,-97,-96,-97,-96
-96,-97,-96,-97,-96,-97,-96,-97,-96,-97,-96,97,96,97,-96,-97,-96,-97,-96,-97,-96,-97,-96,-97,-96
-96,-97,-96,-97,-96,-97,-96,-97,-96,-97,-96,97,96,97,-96,-97,-96,-97,-96,-97,-96,-97,-96,-97,-96
-96,-97,-96,-97,-96,-97,-96,-97,-96,-97,-96,97,96,97,-96,-97,-96,-97,-96,-97,-96,-97,-96,-97,-96
-96,-97,-96,-97,-96,-97,-96,-97,-96,-97,-96,97,96,97,-96,-97,-96,-97,-96,-97,-96,-97,-96,-97,-96
-96,-97,-96,-97,-96,-97,-96,-97,-96,-97,-96,97,96,97,-96,-97,-96,-97,-96,-97,-96,-97,-96,-97,-96
72,73,73,73,73,73,73,73,73,73,73,73,73,73,73,73,73,73,73,73,73,73,73,73,74
80,0,0,0,0,0,0,0,0,0,0,0,0,0,0,0,0,0,0,0,0,0,0,0,0,0,0,0,82
80,0,0,0,0,0,0,0,0,0,0,0,0,0,0,0,0,0,0,0,0,0,0,0,0,0,0,0,82
80,0,0,0,0,0,0,0,0,0,0,0,0,0,0,0,0,0,0,0,0,0,0,0,0,0,0,0,82
80,0,0,0,0,0,0,0,0,0,0,0,0,0,0,0,0,0,0,0,0,0,0,0,0,0,0,0,82
80,0,0,0,0,0,0,0,0,0,0,0,0,0,0,0,0,0,0,0,0,0,0,0,0,0,0,0,82
80,0,0,0,0,0,0,0,0,0,0,0,0,0,0,0,0,0,0,0,0,0,0,0,0,0,0,0,82
80,0,0,0,0,0,0,0,0,0,0,0,0,0,0,0,0,0,0,0,0,0,0,0,0,0,0,0,82
80,0,0,0,0,0,0,0,0,0,0,0,0,0,0,0,0,0,0,0,0,0,0,0,0,0,0,0,82
