25
20
592, 594, 590, 592, 594, 590, 592, 594, 590, 592, 594, 631, 597, 594, 590, 592, 594, 590, 592, 594, 590, 592, 594, 590, 592
590, 592, 594, 590, 592, 594, 590, 592, 594, 590, 592, 631, 597, 592, 594, 590, 592, 594, 590, 592, 594, 590, 592, 594, 590
592, 594, 590, 592, 594, 590, 592, 594, 590, 592, 594, 631, 597, 594, 590, 592, 594, 590, 592, 594, 590, 592, 594, 590, 592
590, 592, 594, 590, 592, 594, 590, 592, 594, 590, 592, 631, 597, 592, 594, 590, 592, 594, 590, 592, 594, 590, 592, 594, 590
592, 594, 590, 592, 594, 590, 592, 594, 590, 592, 594, 631, 597, 594, 590, 592, 594, 590, 592, 594, 590, 592, 594, 590, 592
590, 592, 594, 590, 592, 594, 590, 592, 594, 590, 592, 631, 597, 592, 594, 590, 592, 594, 590, 592, 594, 590, 592, 594, 590
592, 594, 590, 592, 594, 590, 592, 594, 590, 592, 594, 631, 597, 594, 590, 592, 594, 590, 592, 594, 590, 592, 594, 590, 592
590, 592, 594, 590, 592, 594, 590, 592, 594, 590, 592, 631, 597, 592, 594, 590, 592, 594, 590, 592, 594, 590, 592, 594, 590
592, 594, 590, 592, 594, 590, 592, 594, 590, 592, 594, 631, 597, 594, 590, 592, 594, 590, 592, 594, 590, 592, 594, 590, 592
590, 592, 594, 590, 592, 594, 590, 592, 594, 590, 592, 631, 597, 592, 594, 590, 592, 594, 590, 592, 594, 590, 592, 594, 590
592, 594, 590, 592, 594, 590, 592, 594, 590, 592, 594, 631, 597, 594, 590, 592, 594, 590, 592, 594, 590, 592, 594, 590, 592
590, 592, 594, 590, 592, 594, 590, 592, 594, 590, 592, 631, 597, 592, 594, 590, 592, 594, 590, 592, 594, 590, 592, 594, 590
592, 594, 590, 592, 594, 590, 592, 594, 590, 592, 594, 631, 597, 594, 590, 592, 594, 590, 592, 594, 590, 592, 594, 590, 592
590, 592, 594, 590, 592, 594, 590, 592, 594, 590, 592, 631, 597, 592, 594, 590, 592, 594, 590, 592, 594, 590, 592, 594, 590
592, 594, 590, 592, 594, 590, 592, 594, 590, 592, 594, 631, 597, 594, 590, 592, 594, 590, 592, 594, 590, 592, 594, 590, 592
590, 592, 594, 590, 592, 594, 590, 592, 594, 590, 592, 631, 597, 592, 594, 590, 592, 594, 590, 592, 594, 590, 592, 594, 590
592, 594, 590, 592, 594, 590, 592, 594, 590, 592, 594, 631, 597, 594, 590, 592, 594, 590, 592, 594, 590, 592, 594, 590, 592
590, 592, 594, 590, 592, 594, 590, 592, 594, 590, 592, 631, 597, 592, 594, 590, 592, 594, 590, 592, 594, 590, 592, 594, 590
592, 594, 590, 592, 594, 590, 592, 594, 590, 592, 594, 631, 597, 594, 590, 592, 594, 590, 592, 594, 590, 592, 594, 590, 592
590, 592, 594, 590, 592, 594, 590, 592, 594, 590, 592, 631, 597, 592, 594, 590, 592, 594, 590, 592, 594, 590, 592, 594, 590